##########
##&X  ####
## B#  ###
## B . ###
##.   ####
##########