########
#      #
##&   ##
##.BX  #
##  #  #
#      #
#      #
########