##########
#        #
##  &   ##
##.  B   #
##  #    #
#    B   #
#   .    #
##########