##########
##     ###
## ..   ##
## # BBB##
##   #&.##
##########