#########
#   #  .#
#   # . #
##B     #
##  .B ##
### B####
####&####
#########