########
#      #
##  & ##
##.BB  #
##  #  #
#      #
#   .  #
########